a,0,0,0,0,0,0,0,1,0,0,0,0,0,0
0,1,1,1,1,0,a,1,1,1,1,1,1,1,1
0,1,0,1,0,0,1,0,1,0,0,0,0,0,0
0,0,1,1,1,1,1,0,1,0,0,0,0,0,0
0,0,0,1,0,1,c,0,1,0,0,0,0,0,0
0,0,0,1,0,0,0,0,1,0,0,0,0,0,0
0,1,1,1,1,1,1,0,1,0,0,0,0,0,0
0,1,0,1,0,0,0,0,0,0,0,0,0,0,0
0,1,0,1,1,1,-51,1,1,0,0,0,0,0,0
1,1,0,1,0,0,0,1,0,0,0,0,0,0,0
0,0,0,1,0,0,0,1,0,0,0,0,0,0,0
0,0,0,1,0,0,0,1,0,0,0,0,0,0,0
0,0,0,1,0,0,0,1,0,0,0,0,0,0,0
0,0,0,1,0,0,0,1,0,0,0,0,0,0,0
