0,0,0,0,0,0,0,0,1,0,0,0,0,0,0
0,1,1,1,1,0,1,1,1,1,1,1,1,1,1
0,1,0,1,0,0,1,0,1,0,0,0,0,0,0
0,0,1,1,1,1,1,0,1,0,0,0,0,0,0
0,0,0,1,0,1,0,0,1,0,0,0,0,0,0
0,0,0,1,0,0,0,0,1,0,0,0,0,0,0
0,1,1,1,1,1,1,0,10065,0,0,0,0,0,0
0,1,0,1,0,0,0,0,0,4560,0,0,0,0,0
0,1,0,1,1,1,1,1,1,0,0,0,0,0,0
1,1,0,1,0,0,0,1,0,0,0,0,0,0,0
0,0,0,1,0,0,0,1,0,0,0,0,0,0,0
0,0,0,1,0,69990,0,1,0,0,0,0,0
0,0,0,1,0,0,0,1,0,0,0,0,0,0,0
0,0,0,1,0,0,0,1,0,0,0,0,0,0,0
